5 20
.**............+....
...****+........*...
............*....*..
............+.....*.
......***+..........